1;1;46;1;60;1
wwwwwwwwwwwwwwwwwwwwwwwwwwwwwwwwwwwwwwwwwwwwbwwwwwwwwwwwwwwwwwwwwwwww
w       M     M                            w                        w
w          M     M                         wwwwwwwwwwwwwwwwwwwwwwww w
w       M     M                                                     w
w          M     M                          wwwwwwwwwwwwwwww        w
w       M     M            MMMMMMMM              M         w        w
w          M     M                          MMMMMM                  w
wwwwwwwwwwwwwwwwwwwwwwwwwwwwwwwwwwwwwwwwwwwwwwwwwwwwwwwwwwwwwwwwwwwww
