1;1;6;9;10;1
MMMMMMMMMMMWWWWWWWWWWWWWWWWWWWWWWWWWWwww
M         MW                           w
M  B   B  MWWWWWWWWWWWWWWWWWWWW WWWWWw w
M B     B MWBBBBBBBBBBBBBBBBBBB BBBB w w
M         MRB                      B w w
M    E                        w    B w w
M    E                        w    B w w
M    E                        w    B w w
M    E                        w    B w w
M    E                        w    B w w
M    E                        w    B w w
M    E                        w    B w w
M    E                        w    B w w
M    E                        w    B w w
M    E                        w    B w w
M    E                        w    B w w
M    E                        w    B w w
M    E                        w    B w w
M    E                        w    B w w
M         MRB                 B    B w w
M B     B MBB                 w    BBB B
M  B   B  MB                           B
M         MB                       BBBBB
MMMMMMMMMMMBBBBBBBBBBBBBBBBBBBBBBBBB
